NO ./n.xpm
SO ./s.xpm
WE ./w.xpm
EA ./e.xpm
F 
C 225,30,0

111111
1N001
111111
